00000000000000000000000000000000000000000000000000
00000000000000000000000000000000000000000000000000
11100001111111111111111111111111111111111111111111
10000000000000000000000000000000000000000000000001
10000000000000000000000000000000000000000000000001
10000000000000000000000000000000000000000000000001
10000000100000100000100000000000000000000000000001
10000000100000100000100000000000000000000000000001
10000000100000100000100000000000000000000000000001
10000000100000100000100000000000000000000000000001
10000000100000100000100000000000000000000000000001
10000000100000100000100000000000000000000000000001
10000000100000100000100000000000000000000000000001
10000000100000100000100000000000000000000000000001
10000000100000100000100000000000000000000000000001
10000000100000100000100000000000000000000000000001
10000000100000100000100000000000000000000000000001
10000000100000100000100000000000000000000000000001
10000000100000100000100000000000000000000000000001
10000000100000100000100000000000000000000000000001
10000000100000100000100000000000000000000000000001
10000000100000100000100000000000000000000000000001
10000000100000100000100000000000000000000000000001
10000000100000000000100000000000000000000000000001
10000000100000100000100000000000000000000000000001
10000000100000100000100000000000000000000000000001
10000000100000100000100000000000000000000000000001
10000000100000100000100000000000000000000000000001
10000000100000100000100000000000000000000000000001
10000000100000100000100000000000000000000000000001
10000000100000100000100000000000000000000000000001
10000000000000000000000000000000000000000000000001
10000000000000000000000000000000000000000000000001
10000000000000000000000000000000000000000000000001
11111111112221112221111111111111111111111111111111
000000001     1     1
000000001     1     1
000000001111111111111