1111111111111111111111111
1000000000000000000000001
1000000000100000000000001
1000000000100000000001111
1011100111111111111111001
1010000000000100000010001
1010000000000100000010001
1010000110011100110010001
1000000100000000100000001
1000000100000000100000001
1111111111111111110010001
1000000000000100000010001
1000000000000100000000001
1001001111001110011110001
1001000010000000000010001
1001000010000000000010001
1001111111111111111110001
1000000000000000000010001
1000000000000000000010001
1111222111111111111111111